%%%%%%%%%%%%%%
%      %P    %
%      %     %
%      %%%%  %
%         %  %
%         %  %
%  %%%       %
%  %         %
%  %         %
%  .%        %
%%%%%%%%%%%%%%